0000000000000000000000000
0000000000000000000000000
0000000000000000000000000
0000000000000000000000000
0000000000000000000000333
0000000000000000000000033
0330000000000000000000033
0330000000000000000000333
0330000000000000000000333
0333000000000000000000333
0330000033000000000333333
0333000333000000000000333
0330003330000000000000333
0330000000000000000000333
0300000000000000000000333
0330000000000000000000333
0333333000000000000000333
0333333300000000000000333
0300000000300300330000333
0300000000300300330000333
0300000333300300330000333
0333333333300333333003333
0333333333300333333003333
0333333333300333333003333
0333333333300333333003333
0333333333300333333003333
0300000000000000000003333
0300000000000000000003333
0330000003330033333003333
0333300333330033333003333
0333300333330033333003333
0333000000000000000000033
0300000000000000000000033
0300000003333330003333333
0300000003330000000000003
0333300000000000000000003
0333300000333330000333333
0300000000333330000333333
0300000033300000000003333
0300000033300000000003333
0300000033333330000333333
0033333300300000000000000
0333330030000000000000003
0333330033333333333333333
0333333333333333333333333
0333333333333333333333333
0333333333333333333333333
0333333333333333333333333
0333333333333333333333333