0000000000000000000000000
0000000000000000000000000
0000000000000000000000000
0000000000000000000000000
0000000000000000000000000
0000000000000000000000000
0000000000003300000000000
0000000030000300000000000
0000000000000300000000000
0000000000000300000000000
0000000000000333300000000
0000003300033300000000000
0000333300300300000000000
0000000300000300000000000
0000000300300300000000000
0000000330000300000000000
0000000330000300000000000
0000000000000300000000000
0000000000000300000000000
0000000000000300000000000
0000000000000000000000000
0000000000000000000000000
0000000000000000000000000
0000000000000000000000000
0000000300000000000000000
0000000300003000000000000
0000000300003000000000000
0000000300003000000000000
0000000330003333000000000
0000003300333003000000000
0000333300003000000000000
0000000300030030300000000
0000000330030030030000000
0000000300300030000000000
0000000300003300000000000
0000003000003300000000000
0000000000000000000000000
0000000000000000000000000
0000000000000000000000000
0000000000000000000000000
0000000000000000000000000
0000000000000000000000000
0000000000000000000000000
0000000000000000000000000
